###############
#....~~~~~....#
#....~~~~~....#
#.............#
#.....####....#
#........#....#
#........#....#
###############